66 60
111111111111111111111111111111111111111111111111111111111111111111
100000000001101000000000000000000000000000000000000000000000011111
100000000001101000000000000000000000000000000000000000000000000111
100000000001101000000000000000000000000000000000000000000000000011
100000000001101000000000000000000000000000000000000000000000000000
100000000001111000000000000000000000000000000000000000000000000011
100000000001111000000000000000000000000000000000000000000000000001
100000000001111000000000000000000000000000000000000000000000000001
100000000001111000000000000000000000000000000000000000000000000001
100000000001111000000000000000000000000000000000000000000000000000
100000000000111000000000000000000000000000000000000000000000000000
100000000000111000000000000000000000000000000000000000000000000001
100000000000011000000000001111111111111111111111100000000000000001
100000000000011000000000000000000000000000011111111100000000000001
100000000000010000000000000000000000000000000000001110000000000001
100000000000010000000000000000000000000000000000000111000000000001
100000000000010000000000000000000000000000000000000011000000000001
100000000000011000000000000000000000000000000000000011000000000001
100000000000011000000000000000000000000000000000000011000000000001
100000000000001100000000000000000000000000000000000011000000000001
100000000000001100000000000000000000000000000000000001000000000001
100000000000001110000000000000000000000000000000000001000000000001
100000000000011110000000000000000000000000000000000001100000000001
100000000000011110000000000000000000000000000000000001100000000001
100000000000011110000000000000000000000000000000000001100000000001
100000000000010111110001111001111100000000000000000001100000000001
100000000000010110001110001111111111111000000000000001100000000001
100000000000010111111000111111000000001100000000000000100000000001
100000000000011110000000000000000000000110000000000000100000000001
100000000000011100000000000000000000000010000000000000100000000001
100000000000011000000000000000000000000011000000000000100000000001
100000000000011000000000000000000000000001000000000000100000000001
100000000000011000000000000000000000000001000000000000100000000001
100000000000010000000000000000000000000001000000000000100000000001
100000000000010000000000000000000000000001000000000000100000000001
100000000000010000000000000000000000000001000000000000100000000001
100000000000010000000000000000000000000001000000000000100000000001
100000000000010000000000000000000000000001000000000000100000000001
100000000000010000000000000000000000000001000000000000100000000001
100000000000110000000000000000000000000001000000000001100000000001
100000000000110000000000000000000000000001000000000001000000000001
100000000000100000000000000000000000000001000000000001000000000001
100000000000110000000000000000000000000001000000000001000000000001
100000000000010000000000000000000000000001000000000001000000000001
100000000000010000000000001000000000000001000000000001000000000001
100000000000010000000000001000000000000111000000000001000000000001
100000000000000000000000001000000000001111000000000001000000000001
100000000000000000000000001000000000001111000000000001000000000001
100000000000000000000000001000000000000000000000000001000000000001
100000000000000000000000001000000000000000000000000001000000000001
100000000000000000000000001000000000000000000000000001000000000001
100000000000000000000000011000000000000000000000000001000000000001
100000000000000000000000111000000000000000000000000011000000000001
100000000000000000000001111000000000000000000000000010000000000001
100000000000000000000011111100000000000000000000000111000000000001
100000000000000000000111111100000000000000000000001111100000000001
110000000000000000001111111110000000000000000000011111110000000011
111000000000000000111111111110000000000000000000111111111000000111
111111111111111111111111111101100000000000000111111111101100000111
111111111111111111111111111111111111111111111111111111111111111111
